W   W      W   W
W   W      W   W
LSR  T     W   W
W  L### ###R   W
W          W   W
W      #   W   W
W      L# <R   W
W              W
W       F#     W
L>>t#R#L###t ##R
W      
W        T      
L#####R  #L#<<####R
123