W   W   8  W   W
W   W   8  W   W
W          W   W
L#R     W  W   W
W  L#####  W   W
W          W   W
T      L#<<R   W
W              W
W   F       T W
L>>8### ###S##R
W      
W        T      F
L##tR  #L#<<#tStR
123