W   W   8  W   W
W   W   8  W   W
W          W   W
LSR     W  W   W
W  L#####  W   W
W          W   W
W      L#<<R   W
W              W
W      T     T W
L>>8##########R
W      
W        T F     
L##tSSR  #L#<<#t#tR
123