W          W   W
W          W   W
LSR        W   W8
W  L#######R   W
W          W   W
W          W   W
W      L#<<R   W
W              W
W            T W
L>>##R L#######R
W      
W                F
L#####R   L###t###R
123