         W     W   W
         W     W   W
         W     W   W
         W     W   W
LS#######R     W   W
               W   W
        T   F  W   W
     L#########R   W
                   W
                   W
                   W
                 F W
     L####t########R