         W     W   W
         W     W   W
         W     W   W
         W     W   W
#S########     W   W
               W   W
        T   F  W   W
################   W
                   W
                F  W
##########t#########